##########
#........#
#.####.#.#
#.#..#.#.#
#.#..#.#.#
#........#
#.#..#.#.#
#.#..#.#.#
#.#..#.#.#
#........#
##########
