##########
#........#
#.....#..#
#..#.....#
#........#
#....##..#
#........#
##########