##########
#........#
#.#..#.#.#
#.#..#.###
#.####.#.#
#........#
#........#
#...##.###
#.##.#.###
#........#
##########